# idx : predicted-niveau : root-multiplicity-partition at 5
0 N1 [ 5, 1 ]
1 N1 [ 5, 1 ]
2 N1 [ 5, 1 ]
3 N1 [ 5, 1 ]
4 N2 [ 6 ]
5 N1 [ 5, 1 ]
6 N1 [ 5, 1 ]
7 N2 [ 6 ]
8 N1 [ 5, 1 ]
9 N1 [ 5, 1 ]
10 N2 [ 6 ]
11 N1 [ 5, 1 ]
12 N1 [ 5, 1 ]
13 N2 [ 3, 3 ]
14 N2 [ 3, 3 ]
15 N2 [ 3, 3 ]
16 N1 [ 5, 1 ]
17 N1 [ 5, 1 ]
18 N1 [ 5, 1 ]
19 N2 [ 3, 3 ]
20 N1 [ 5, 1 ]
21 N1 [ 5, 1 ]
22 N1 [ 5, 1 ]
23 N1 [ 5, 1 ]
24 N1 [ 5, 1 ]
25 N1 [ 5, 1 ]
26 N1 [ 5, 1 ]
27 N1 [ 5, 1 ]
28 N1 [ 5, 1 ]
29 N1 [ 5, 1 ]
30 N1 [ 5, 1 ]
31 N2 [ 3, 3 ]
32 N2 [ 3, 3 ]
34 N1 [ 5, 1 ]
35 N1 [ 5, 1 ]
36 N1 [ 5, 1 ]
37 N1 [ 5, 1 ]
38 N1 [ 5, 1 ]
39 N1 [ 5, 1 ]
40 N2 [ 3, 3 ]
41 N2 [ 3, 3 ]
42 N2 [ 3, 3 ]
43 N2 [ 3, 3 ]
44 N1 [ 5, 1 ]
45 N1 [ 5, 1 ]
46 N1 [ 5, 1 ]
47 N1 [ 5, 1 ]
48 N2 [ 6 ]
49 N2 [ 6 ]
50 N2 [ 2, 1, 1 ]
51 N2 [ 2, 1, 1 ]
52 N2 [ 2, 1, 1 ]
55 N2 [ 3, 3 ]
56 N2 [ 3, 3 ]
57 N2 [ 3, 3 ]
58 N2 [ 3, 3 ]
59 N1 [ 5, 1 ]
60 N1 [ 5, 1 ]
61 N1 [ 5, 1 ]
62 N1 [ 5, 1 ]
63 N1 [ 5, 1 ]
64 N1 [ 5, 1 ]
65 N2 [ 3, 3 ]
66 N2 [ 3, 3 ]
67 N2 [ 3, 3 ]
68 N2 [ 3, 3 ]
69 N1 [ 5, 1 ]
70 N1 [ 5, 1 ]
71 N2 [ 2, 1, 1 ]
72 N2 [ 2, 1, 1 ]
